
DADOS DO LOCADOR:

LCDNOME = NOME DO LOCADOR ?
LCDETDCIVIL = ESTADO CIVIL DO LOCADOR ?
LCDTLFN = TELEFONE DO LOCADOR ?
LCDPFSS = PROFISSÃO LOCADOR ?
LCDRG = RG DO LOCADOR ?
LCDCPF = CPF DO LOCADOR ?
LCDLGD = LOGRADOURO DO LOCADOR 
LCDNMR = NÚMERO DO ENDEREÇO DO LOCADOR
LCDCMP = COMPLEMENTO DO ENDEREÇO DO LOCADOR
LCDBRR = BAIRRO DO LOCADOR
LCDCDD = CIDADE DO LOCADOR
LCDCEP = CEP DO LOCADOR

DADOS DO LOCATÁRIO:

LCTNNOME = NOME DO LOCATÁRIO
LCTETDCIVIL = ESTADO CIVIL DO LOCATÁRIO
LCTTLFN = TELEFONE DO LOCATÁRIO
LCTPFSS = PROFISSÃO DO LOCATÁRIO
LCTRG = RG DO LOCATÁRIO
LCTCPF = CPF DO LOCATÁRIO

OBJETO DE LOCAÇÃO:

OBJLGD = LOGRADOURO DO OBJETO DO CONTRATO
OBJNMR = NUMERO DO OBJETO DO CONTRATO
OBJCMP = COMPLEMENTO DO OBJETO DO CONTRATO
OBJBRR = BAIRRO DO OBJETO DO CONTRATO
OBJCDD = CIDADE DO OBJETO DO CONTRATO
OBJCEP = CEP DO OBJETO DO CONTRATO

DEMAIS SIGLAS:

LCCPRD = PERÍODO DE LOCAÇÃO
MLTMSS = MESES DE MULTA (quantos meses o locatário precisa pagar de multa caso reinscida o contrato antes do prazo final)
VLRALGL = VALOR DO ALUGUEL
DTALGL = DATA LIMITE PARA PAGAMENTO ALUGUEL
MLTALGL = MULTA POR ATRASO DO ALUGUEL (em reais R$)
JRALGL = JUROS POR ATRASO DO ALUGUEL (porcentagem %)
ATSALGL = TEMPO LIMITE DE ATRASO PARA PAGAMENTO DO ALUGUEL
DSCNTS = DIAS PARA PASSAR AS CONTAS PARA O NOME (gás, luz, água, etc)
CMRCCDD = COMARCA DA CIDADE
ETDCMRC = SIGLA DO ESTADO DA COMARCA
CDD = CIDADE ONDE O CONTRATO FOI LAVRADO
ESTD = SIGLA DO ESTADO ONDE O CONTRATO FOI LAVRADO
DATL = DIA EM QUE FOI LAVRADO O CONTRATO
MSATL = MES QUE FOI LAVRADO O CONTRATO
UNANO = UNIDADE FINAL DO ANO EM QUE FOI LAVRADO O CONTRATO

